{
  "levels": [
	{
	  "name": "Level 1",
	  "rows": [
		"########",
		"#...####",
		"#.....##",
		"##.....#",
		"#......#",
		"#...#..#",
		"#P.....#",
        "########"
	  ]
	},
	{
	  "name": "Level 2",
	  "rows": [
		"###########",
		"#......#..#",
		"#......#..#",
		"######.#..#",
		"######.#..#",
		"######.#..#",
		"######.#..#",
		"#......#..#",
		"#.####.#..#",
		"#.####.#..#",
		"#.####.#..#",
		"#.........#",
		"#P.......##",
        "###########"
	  ]
	},
	{
	  "name": "Level 3",
	  "rows": [
		"############",
		"#..........#",
		"#..#..####.#",
		"#..#..####.#",
		"#..#..####.#",
		"#..#..####.#",
		"#..#..####.#",
		"#..#.......#",
		"#P....######",
		"##.##.######",
		"##.........#",
		"#####......#",
        "############"
	  ]
	},
	{
	  "name": "Level 4",
	  "rows": [
		"########",
		"#...####",
		"#...####",
		"#...##.#",
		"##.....#",
		"#......#",
		"#...#..#",
		"#P..#..#",
        "########"
	  ]
	},
	{
	  "name": "Level 5",
	  "rows": [
		"###########",
		"#.........#",
		"#...#####.#",
		"###....##.#",
		"######.##.#",
		"#.........#",
		"#.####.##.#",
		"#.#.......#",
		"#.#.##.####",
		"#.#.......#",
		"#.#.##.##.#",
		"#.#.##.##.#",
		"#.#.##.##.#",
		"#P........#",
        "###########"
	  ]
	},
	{
	  "name": "Level 6",
	  "rows": [
		"########",
		"#...#..#",
		"#......#",
		"#......#",
		"#......#",
		"#......#",
		"#......#",
		"#..#...#",
		"#P....##",
		"##...###",
        "########"
	  ]
	},
	{
	  "name": "Level 7",
	  "rows": [
		"############",
		"#.........##",
		"#.##.#.....#",
		"#.##.#.#...#",
		"#.##.#.#...#",
		"#.##.#.#...#",
		"#.##.#.#...#",
		"#..........#",
		"####.#.#...#",
		"####.#.#...#",
		"#P.........#",
		"####.#.#..##",
		"####.#.#####",
		"####...#####",
        "############"
	  ]
	},
	{
	  "name": "Level 8",
	  "rows": [
		"#########",
		"#...##..#",
		"#...##..#",
		"#.......#",
		"#.......#",
		"#....####",
		"#.....###",
		"#P.#..###",
        "#########"
	  ]
	},
	{
	  "name": "Level 9",
	  "rows": [
		"############",
		"##.........#",
		"#......###.#",
		"#..#.#.###.#",
		"#..#.#.###.#",
		"#..#.#.###.#",
		"#..#.......#",
		"#..#.#.#####",
		"#..#.......#",
		"#P.........#",
		"#.####.###.#",
		"#..........#",
        "############"
	  ]
	},
	{
	  "name": "Level 10",
	  "rows": [
		"############",
		"##........##",
		"#.........##",
		"#..........#",
		"#..######..#",
		"#..######..#",
		"#..######..#",
		"#..######..#",
		"#..#.......#",
		"#..#.####..#",
		"#..#.####..#",
		"#..#.......#",
		"#P.##.....##",
        "############"
	  ]
	},
	{
	  "name": "Level 11",
	  "rows": [
		"########",
		"#.....##",
		"#..#..##",
		"#......#",
		"#......#",
		"#....#.#",
		"##.....#",
		"#......#",
		"#P....##",
        "########"
	  ]
	},
	{
	  "name": "Level 12",
	  "rows": [
		"#############",
		"#####.......#",
		"#####.###.#.#",
		"##.....##.#.#",
		"##.##..##.#.#",
		"##.##..##.#.#",
		"#.........#.#",
		"#..##..##.#.#",
		"#......##.#.#",
		"#..###.##.#.#",
		"#..###.##.#.#",
		"#...........#",
		"#P........###",
		"##........###",
        "#############"
	  ]
	},
	{
	  "name": "Level 13",
	  "rows": [
		"##########",
		"#.....####",
		"#........#",
		"#..#..##.#",
		"#........#",
		"#.......##",
		"##.......#",
		"#........#",
		"#P...##..#",
        "##########"
	  ]
	},
	{
	  "name": "Level 14",
	  "rows": [
		"############",
		"##......#..#",
		"##.##.#.#..#",
		"#.....#.#..#",
		"#..##.#.#..#",
		"#..##.#.#..#",
		"#..##.#.#..#",
		"#..........#",
		"#.###.#....#",
		"#.###.#....#",
		"#.###.#....#",
		"#.###.#....#",
		"#..........#",
		"#P.......###",
        "############"
	  ]
	},
	{
	  "name": "Level 15",
	  "rows": [
		"#########",
		"#..######",
		"#..######",
		"#.......#",
		"#.......#",
		"#.#.....#",
		"#......##",
		"##......#",
		"#.......#",
		"#P.#...##",
        "#########"
	  ]
	},
	{
	  "name": "BOSS LEVEL",
	  "rows": [
		"######################",
		"####.......###########",
		"####.###.......#######",
		"#.....##.#.###.......#",
		"#.##.........#.###.#.#",
		"#.###.##.#.#.#.###.#.#",
		"#.#......#.#.#.#...#.#",
		"#........#...#.#.#.#.#",
		"#...#.##.#.##......#.#",
		"#..............#.#.#.#",
		"#...#.#....##..#.#...#",
		"#...#.#....##..#.#####",
		"#....................#",
		"##.............#.###.#",
		"##..###..........###.#",
		"###.###....##....###.#",
		"#....................#",
		"#.#.####...##...####.#",
		"#...####.............#",
		"#...####....#........#",
		"#...........#...######",
		"#.........#.##..######",
		"#...#######.##..######",
		"#............#..######",
		"#...########.........#",
		"#...#######..........#",
		"#P..........##.......#",
		"##..#######.###.####.#",
		"##..........###......#",
		"######################"
	  ]
	}
  ]
}
