{
  "levels": [
	{
	  "name": "Offener Einstieg",
	  "rows": [
		"###########",
		"#P........#",
		"#.........#",
		"#........##",
		"##.......##",
		"##......###",
		"#######.###",
		"#.........#",
        "###########"
	  ]
	},
	{
	  "name": "Breite Flaechen",
	  "rows": [
		"#############",
		"#P..........#",
		"#...........#",
		"#..........##",
		"##.........##",
		"##........###",
		"#########.###",
		"#########.###",
		"#...........#",
        "#############"
	  ]
	},
	{
	  "name": "Grosse Halle",
	  "rows": [
		"###############",
		"#P............#",
		"#.............#",
		"#............##",
		"##...........##",
		"##..........###",
		"###.........###",
		"###........####",
		"##########.####",
		"#.............#",
        "###############"
	  ]
	}
  ]
}
